Bello=Hello
Poopaye=Goodbye
Tank yu=Thank you
Me want banana=I'm hungry
Bananonina=Ugly
Underwear=I swear
Bee Do Bee Do Bee Do=Fire
Tulaliloo ti amo=We love you
Tatata bala tu=I hate you
Baboi=Toy
Po ka=What
Bable=Apple
Gelatoooo=Ice cream
Butt=ass
Hana=One
Hana=1
Dul=2
Sae=3
Dul=Two
Sae=Three
Para tu=For you
Chasy=Chair
Kan pai=Cheers
Pwede na=Can we start
Luk at tu=Look at you
Muak=kiss
Bi do=I'm sorry
La Boda=Marriage
Buttom=Bottom
Stupa=Stop
Sa la ka=How dare you



